#########################################
# #   #             #   #   # # #   #   #
# # ### # ############# ### # # ### # ###
#     # #           # #         #   #   #
# ########### ### # # # ### ### # # # ###
#   # # #     # # # #   #   #   # #   # #
# ### # # ### # ### ######### # # ##### #
#   # # # #       # # # # #   # #       #
# # # # # ####### # # # # # ##### # #####
# #   #       # # #   # # #     # #   # #
# # ##### ### # # ##### # # # ### ### # #
# # #   # #     # #     #   #       #   #
# # # ### ######### # ### ##### # ### # #
# #     #   # #     # #   #     # # # # #
### # # ### # # ### ### # ### ##### # # #
# # # #   #       #     # #     # # # # #
# # # ##### ############# # ### # # # # #
#   #     #   #     # # # #   #   #   # #
####### ### ####### # # # ##### ### # ###
#       # #   # #   #         #   # #   #
# ##### # # ### # # ### ### # # ### ### #
# # # #       # # #     #   # # #     # #
# # # # # ##### ####### ######### # #####
#   # # #       #     # #     # # #     #
# # # # ########### ##### ### # # #######
# # #         # #   # # #   # #     #   #
# ### # ### ### ### # # ### # ### ##### #
#   # #   #   # #   #       # # # #     #
# # ### # # # # ### ### ##### # # ##### #
# # #   # # #       #   #               #
#########################################